#############
#...........#
#.T.T.T.T.T.#
+...........+
#.T.T.T.T.T.#
#...........#
###S#########
