###################
#~~~~~~~~~~~~~~~~~#
#~~.............~~#
#~.......<.......~#
#~...............~#
#~...............~#
#~...............~#
#~...............~#
#~...............~#
#~...............~#
#~...............~#
#~...............~#
#~...............~#
#~...............~#
#~...............~#
#~.......>.......~#
#~~.............~~#
#~~~~~~~~~~~~~~~~~#
###################
