#################
#........~~.....#
#.......<..~....#
#..........~....#
#..........~....#
#..........~....#
#.........~.....#
#........~......#
#.......~.......#
#......~........#
#.....~.........#
#....~..........#
#....~..........#
#....~..........#
#....~..>.......#
#.....~~........#
#################
