#################
#######.>.#######
#######...#######
#~~~~~~~.~~~~~~~#
#~~~~~~~.~~~~~~~#
#~~~~~~~.~~~~~~~#
#~~~~~~...~~~~~~#
#~~~~.......~~~~#
#~~~~.......~~~~#
#~~~#.......#~~~#
#~~~.........~~~#
#~~~#.......#~~~#
#~~~~.......~~~~#
#~~~~.......~~~~#
#~~~~~~...~~~~~~#
#~~~~~~~.~~~~~~~#
#~~~~~~~.~~~~~~~#
#~~~~~~~.~~~~~~~#
#######...#######
#######.<.#######
#################
