#################
##.............##
#.......#.......#
#......###......#
#.....#####.....#
#.....#####.....#
#......###......#
#.......#.......#
#...............#
#.......#.......#
#......###......#
#.....#####.....#
#.....#####.....#
#......###......#
#.......#.......#
##.............##
#################
