#################
#...............#
#.......<.......#
#...............#
#...............#
#...............#
#...............#
#.......#.......#
#......###......#
#.......#.......#
#...............#
#...............#
#...............#
#...............#
#.......>.......#
#...............#
#################
