###########################################################################
#............................................##############################
##.............................................############################
####......................................--.....##########################
######...................................--........########################
########................................--...........######################
##########.............................--..............####################
############..........................--.................##################
##############.......................--....................################
################....................--.......................##############
##################.................--..........................############
####################..............--.............................##########
######################...........--................................########
########################........--...................................######
##########################.....--......................................####
############################.............................................##
##############################............................................#
###########################################################################
