###########################################################################
#########################################################...###############
#################################################.........G...#############
#########################################.......................###########
#################################.................................#########
#########################...........................................#######
#################.....................................................#####
#########...............................................................###
#.........................................................................#
#.G.....................................................................G.#
#.........................................................................#
###...............................................................#########
#####.....................................................#################
#######...........................................#########################
#########.................................#################################
###########.......................#########################################
#############...G.........#################################################
###############...#########################################################
###########################################################################
