###########################################################################
#.........#######################################################.........#
#.........#######################################################.........#
###...................###############################...................###
####.............................#########.............................####
#####.................................................................#####
######...............................................................######
#######.............................................................#######
########...........................................................########
########...........................................................########
#######.............................................................#######
######...............................................................######
#####.................................................................#####
####.............................#########.............................####
###...................###############################...................###
#.........#######################################################.........#
#.........#######################################################.........#
###########################################################################
