##########################################################################
#############################................#############################
#####################................................#####################
###############............................................###############
##########......................................................##########
#######............................................................#######
#####................................................................#####
###....................................................................###
#........................................................................#
#........................................................................#
#........................................................................#
###....................................................................###
#####................................................................#####
#######............................................................#######
##########......................................................##########
###############............................................###############
#####################................................#####################
#############################................#############################
##########################################################################
