#################
#...#...#...#...#
#.#.#.#.#.#.#.#.#
#.......#.......#
#.#####.#.#####.#
#.......#.......#
#.#.#.#.#.#.#.#.#
#...#.......#...#
###.#.#####.#.###
#...#.......#...#
#.#.#.#.#.#.#.#.#
#.......#.......#
#.#####.#.#####.#
#.......#.......#
#.#.#.#.#.#.#.#.#
#...#...#...#...#
#################
