#################
#...............#
#.......<.......#
#...............#
#...............#
#~..............#
#~~.............#
#~~~....~~~~~...#
#.~~~~~~x~~~~~~.#
#...~~~~~....~~~#
#.............~~#
#..............~#
#...............#
#...............#
#.......>.......#
#...............#
#################
