###+###
#.....#
+.XXX.#
#.X1X.#
#.XxX.+
#.....#
#######
