##.#########.##
#...#######...#
..#.........#..
#...#######...#
##.#########.##
##.#########.##
##.#########.##
##.#########.##
##.#########.##
##.#########.##
##.#########.##
#...#######...#
..#.........#..
#...#######...#
##.#########.##
