#####+###
#.#.#.#.#
##.#.#.##
+.#.#.#.#
##.#.#.##
#.#.#.#.+
###+#####
