###.###
#.....#
#.###.#
..###..
#.###.#
#.....#
###.###
