######+###
#@.#.....#
#..S.....#
####.....#
#........#
#.########
#.........
##########
