######+###
#..#.....#
#..S.....#
####.....#
#........#
#.########
#.........
##########
