###.###
##.#.##
#.###.#
.#####.
#.###.#
##.#.##
###.###
