###+###
##...##
#..#..#
+..#..+
#..#..#
##...##
###+###
