###+###
##...##
#.....#
+.###.+
#.....#
##...##
###+###
