###+###
##...##
#.....#
+..#..+
#.....#
##...##
###+###
