###+###
##...##
#.#.#.#
+..#..+
#.#.#.#
##...##
###+###
