###.###
##...##
#.===.#
..=)=..
#.===.#
##...##
###.###
