###+###
##...##
#.#...#
+..#..+
#...#.#
##...##
###+###
