###.###
##.#.##
#.##S.#
.##)##.
#.S##.#
##.#.##
###.###
