###+###
##...##
#.....#
+.....+
#.....#
##...##
###+###
