###.###
##.#.##
#.###.#
.##)##.
#.#S#.#
##.#.##
###.###
