######   ######,,,######   ######
#....#   #....#,,,#....#   #....#
#....#   #....#,,,#....#   #....#
#....#####....##+##....#####....#
##+###...##+###...###+##...###+##
 #...+...+....+...+....+...+...#
 ######+#################+######
  ##.##.###.####.####.###.##.##
  ###..##..###.....###..##..###
   ###...###...###...###...###
   ##.##....####>####....##.##
    ##..##....##.##....##..##
     ###..##....#....##..###
      ####..###...###..####
        ####.#..#..#.####
         #######.#######
           #####+#####           
