######..##
....##..##
....##..##
##........
##........
##..######
##..######
##..######
