##########
#...#....#
+...#....#
#...#!!#.#
#...#..x.#
+...x..#.#
#...#..#.#
##+#####+#
