#####+##
#.!....#
#.!....#
#.!....+
#S#....#
..+....#
#####+##
