####..####
#........#
#.##!!##.#
..#....#..
..S....S..
#.######.#
#........#
####..####
