#.########
#..!.....#
#..!.....+
#..!.....#
#..!.....#
#..##x#..#
#.....#..+
#..#######
