####..####
#........#
#.##S###.#
..!....!..
..!....!..
#.#!!!!#.#
#........#
####..####
