####.####
#..#.#..#
#.......#
##.....##
.........
##.....##
#.......#
#..#.#..#
####.####
