#####+#####
#.........#
#..#...#..#
#.###.###.#
#..#...#..#
+....@....+
#..#...#..#
#.###.###.#
#..#...#..#
#.........#
#####+#####
