####+####
#.......#
#.#####.#
#.#,,,#.#
#.#,@,#.#
#.#,,,#.#
#.##S##.#
.........
#########
