###+###+###
#.........#
#.#.#.#.#.#
+.........+
#.#.~~~.#.#
#...~~~...#
#.#.~~~.#.#
+.........+
#.#.#.#.#.#
#.........#
###+###+###
