###.###
#.....#
#..#..#
..###..
#..#..#
#.....#
###.###
