#########
#.......#
#.##.##.#
#.##.##.#
+.......+
#.##.##.#
#.##.##.#
#.......#
#########
