###########+####
##.....##.....##
#..............#
#..............#
+...#......#...+
#..............#
#..............#
##.....##.....##
####+###########
