###########
#.........#
#.#.#.#.#.#
#.........#
+.........+
#.........#
#.#.#.#.#.#
#.........#
###########
