###+#####
#.......+
#.#.#.#.#
+.......#
#####+###
