####+####
#.......#
#.#...#.#
#.......#
#.#...#.#
#.......#
#.#...#.#
#.......#
#.#...#.#
#.......#
####+####
