#####.#####
####...####
###.....###
##.......##
#...#.#...#
.....>.....
#...#.#...#
##.......##
###.....###
####...####
#####.#####
