#..###..#
#.......#
#..~~~..#
#.~~~~~.#
..~~~~~..
#.~~~~~.#
#..~~~..#
#.......#
###...###
