##+###+##
#.......#
#..~~~..#
#.~~~~~.#
..~~~~~..
..~~~~~..
#.~~~~~.#
#..~~~..#
#.......#
####+####
