####+####
###~.~###
###~.~###
#~~~.~~~#
+.......+
#~~~.~~~#
###~.~###
###~.~###
####+####
