##########
#..#..#..#
#..#..#..#
##+##+##+#
..........
##########
