########+#
#XXXXX#..#
#.....S..#
#....c#..#
#@..cT#..+
#######..#
+........#
#........#
####+#####
