#..#######
#........#
#........#
####S##..#
#.....##.+
.......###
#........#
########+#
