########+#
#.....#..#
#.....S..#
#.....#..#
#.....#..+
#######..#
+........#
#........#
####+#####
