######..##
#...#....#
+...#....#
#...S....#
#...#....#
#...#....#
#...#....#
##+###..##
