#########+########
#####.........####
#####.........####
#...#.........#..#
#...#.........x..#
+...x.........#..+
#...#.........#..#
#...#.........####
#####.........####
#####..#!x!#..####
########...#######
