##+#######
#...#....#
#...x....+
#x####x###
#..#.....#
#..x.....#
+..#.....#
######+###
