######
#....+
#.####
#....#
####.#
+....#
######
