########+#
+........#
#.######.#
#.#rsrr#.#
#.#rrrr#.#
#.#TTTT#.#
#........#
##########
