###########
#.........#
#.#X#X#X#.#
#.X.....X.#
#.#.....#.#
#.X.._..S.#
#.#.....#.#
#.X.....X.#
#.#X#X#X#.#
#.........#
###########

# WoodWall
X RockWall
S SecretDoor
