XXXXXSX
..x...X
X###+##
 #MMMM#
 #MMMM#
 #MMMM#
 #MMMM#
 ##+###X
 X...x..
 XSXXXXX
