#####+#
+...#.#
###.#.#
#..#..#
#.#.###
#.#...+
#+#####
