#+#+#
#.#.#
#...#
##.##
##.##
##+##
