#+#+#
#.#.#
#...#
##.##
+..##
#####
