+#####+
#.###.#
##.#.##
###.###
##.#.##
#.###.#
+#####+
